7TTTTTTTTTTTTTTTTTTTTTTTTTTTTTT9
I..............................D
I..............................D
I..............................D
I..............................D
I..............................D
I..............................D
I..............................D
I..............................D
I..............................D
I..............................D
4..............................D
I..............................D
I..............................D
I..............................D
I..............................D
I..............................D
I..............................D
I..............................D
I..............................D
I..............................D
I..............................D
1BBBBBBBBBBBBBBBBBBBBBBBBBBBBBB3