7TTTTTTTTTTTTTTTTTTTTTTTTTTTTTT9
IRRRRRRRRRRRRRRRRRRRRRRRRRRRRRRD
IRRRRRRRRRRRRRRRRRRRRRRRRRRRRRRD
IRRRRRRRRRRRRRRRRRRRRRRRRRRRRRRD
IRRRRRRRRRRRRRRRRRRRRRRRRRRRRRRD
I..............................D
I.......................r......D
I..............................D
I..............................D
I..............................D
I..............................D
4......................i.......D
I..............................D
I..............................D
I..............................D
I..............................D
I......................r.......D
I..............................D
IRRRRRRRRRRRRRRRRRRRRRRRRRRRRRRD
IRRRRRRRRRRRRRRRRRRRRRRRRRRRRRRD
IRRRRRRRRRRRRRRRRRRRRRRRRRRRRRRD
IRRRRRRRRRRRRRRRRRRRRRRRRRRRRRRD
1BBBBBBBBBBBBBBBBBBBBBBBBBBBBBB3