7TTTTTTTTTTTTTTTTTTTTTTTTTTTTTT9
IRRRRRRRRRRRRRRRRRRRRRRRRRRRRRRD
IRRRRRRRRRRRRRRRRRRRRRRRRRRRRRRD
IRRRRRRRRRRRRRRRRRRRRRRRRRRRRRRD
IRRRRRRRRRRRRRRRRRRRRRRRRRRRRRRD
I..............................D
I.......................V......D
I..............................D
I..............................D
I..............................D
I..............................D
4..............J.......i.......D
I..............................D
I..............................D
I..............................D
I..............................D
I......................V.......D
I..............................D
IRRRRRRRRRRRRRRRRRRRRRRRRRRRRRRD
IRRRRRRRRRRRRRRRRRRRRRRRRRRRRRRD
IRRRRRRRRRRRRRRRRRRRRRRRRRRRRRRD
IRRRRRRRRRRRRRRRRRRRRRRRRRRRRRRD
1BBBBBBBBBBBBBBBBBBBBBBBBBBBBBB3