7TTTTTTTTTTTTTT8TTTTTTTTTTTTTTT9
I..............................D
I..............................D
I..............................D
I..............................D
I..............................D
I..............................D
I..............................D
I..............................D
I..............................D
I..............................D
4..............J...............D
I..............................D
I..............................D
I..............................D
I..............................D
I..............................D
I..............................D
I..............................D
I..............................D
I..............................D
I..............................D
1BBBBBBBBBBBBBB2BBBBBBBBBBBBBBB3