7TTTTTTTTTTTTTTTTTTTTTTTTTTTTTT9
I..............................D
I..............i...............D
I..............................D
IRRRRRRRRRRRRRRRRRRRRRRRRRRRRRRD
IRRRRRRRRRRRRRRRRRRRRRRRRRRRRRRD
IRRRRRRRRRRRRRRRRRRRRRRRRRRRRRRD
IRRRRRRRRRRRRRRRRRRRRRRRRRRRRRRD
IRRRRRRRRRRRRRRRRRRRRRRRRRRRRRRD
I..............................D
I..............................D
4..............................6
I..............................D
I..............................D
IRRRRRRRRRRRRRRRRRRRRRRRRRRRRRRD
IRRRRRRRRRRRRRRRRRRRRRRRRRRRRRRD
IRRRRRRRRRRRRRRRRRRRRRRRRRRRRRRD
IRRRRRRRRRRRRRRRRRRRRRRRRRRRRRRD
IRRRRRRRRRRRRRRRRRRRRRRRRRRRRRRD
I..............................D
I..............i...............D
I..............................D
1BBBBBBBBBBBBBBBBBBBBBBBBBBBBBB3