7TTTTTTTTTTTTTT8TTTTTTTTTTTTTTT9
I..............................D
I..............................D
I..............................D
I..............................D
I..............................D
I..............................D
I..............................D
I..............................D
I..............................D
I..............................D
I..............J...............D
I..............................D
I..............................D
I..............................D
I..............................D
I..............................D
I..............................D
I..............................D
I..............................D
I..............................D
I..............................D
1BBBBBBBBBBBBBBBBBBBBBBBBBBBBBB3